xxxxxxxxxxxxxxx
x-------------x
x----xx-p-----x
x------xx-----x
x-------------x
x-------------x
xxxxxxxxxxxxxxx